{
   "layout": [
      1, 1, 1, 1, 1, 1, 1, 1, 1, 1, 1,
      1, 3, 0, 0, 0, 4, 0, 0, 0, 6, 1,
      1, 3, 0, 4, 0, 4, 0, 4, 4, 4, 1,
      1, 4, 4, 4, 0, 4, 0, 0, 0, 0, 1,
      1, 0, 0, 0, 0, 0, 4, 4, 4, 0, 1,
      1, 0, 4, 4, 4, 0, 4, 0, 0, 0, 1,
      1, 0, 0, 0, 4, 0, 4, 0, 4, 0, 1,
      1, 0, 0, 5, 4, 0, 0, 0, 7, 2, 1,
      1, 1, 1, 1, 1, 1, 1, 1, 1, 1, 1
   ],
   "extra": [
      0, 0, 0, 0, 0, 0, 0, 0, 0, 0, 0,
      0, { "item": "lettuce" }, 0, 0, 0, 0, 0, 0, 0, 0, 0,
      0, { "item": "tomato" }, 0, 0, 0, 0, 0, 0, 0, 0, 0,
      0, 0, 0, 0, 0, 0, 0, 0, 0, 0, 0,
      0, 0, 0, 0, 0, 0, 0, 0, 0, 0, 0,
      0, 0, 0, 0, 0, 0, 0, 0, 0, 0, 0,
      0, 0, 0, 0, 0, 0, 0, 0, 0, 0, 0,
      0, 0, 0, 0, 0, 0, 0, 0, 0, 0, 0,
      0, 0, 0, 0, 0, 0, 0, 0, 0, 0, 0
   ],
   "width": 11,
   "height": 9,
   "minPlayers": 1,
   "maxPlayers": 4,
   "menuOptions": ["salad"],
   "timeSeconds": 100,
   "playerPositions": [
      [5, 4],
      [2, 4],
      [6, 3],
      [7, 7]
   ]
}