{
   "layout": [
      1, 1, 1, 1, 1, 1, 1, 1, 1, 1, 1,
      1, 0, 0, 0, 0, 4, 0, 0, 0, 6, 1,
      1, 3, 0, 4, 0, 4, 0, 4, 4, 4, 1,
      1, 4, 4, 4, 0, 4, 0, 0, 0, 0, 1,
      1, 0, 0, 0, 0, 0, 4, 4, 4, 0, 1,
      1, 0, 4, 4, 4, 0, 4, 0, 0, 0, 1,
      1, 0, 0, 0, 4, 0, 4, 0, 4, 0, 1,
      1, 0, 0, 5, 4, 0, 0, 0, 4, 2, 1,
      1, 1, 1, 1, 1, 1, 1, 1, 1, 1, 1
   ],
   "width": 11,
   "height": 9,
   "minPlayers": 2,
   "maxPlayers": 4,
   "menuOptions": ["salad"],
   "timeSeconds": 100
}