{
   "layout": [
      1, 1, 1, 1, 1, 1, 1, 1, 1,
      1, 4, 0, 0, 4, 0, 0, 6, 1,
      1, 4, 0, 0, 4, 0, 0, 0, 1,
      1, 4, 0, 0, 4, 0, 0, 2, 1,
      1, 5, 0, 0, 4, 0, 0, 3, 1,
      1, 0, 0, 0, 4, 0, 3, 4, 1,
      1, 1, 1, 1, 1, 1, 1, 1, 1
   ],
   "extra": [
      0, 0, 0, 0, 0, 0, 0, 0, 0,
      0, 0, 0, 0, 0, 0, 0, 0, 0,
      0, 0, 0, 0, 0, 0, 0, 0, 0,
      0, 0, 0, 0, 0, 0, 0, 0, 0,
      0, 0, 0, 0, 0, 0, 0, { "item": "tomato" }, 0,
      0, 0, 0, 0, 0, 0, { "item": "lettuce" }, 0, 0,
      0, 0, 0, 0, 0, 0, 0, 0, 0
   ],
   "width": 9,
   "height": 7,
   "minPlayers": 2,
   "maxPlayers": 4,
   "menuOptions": ["salad"],
   "timeSeconds": 80,
   "playerPositions": [
      [5, 2],
      [2, 2],
      [5, 4],
      [2, 4]
   ]
}